20
15
17 17 17 17 17 17 17 17 17 17 17 17 17 17 17 17 17 17 17 17
17 13 11 11 14 17 13 11 11 11 11 14 17 13 11 11 11 11 14 17
17 5  2  3  8  17 9  0  0  0  0  8  17 9  0  0  0  0  8  17
17 18 18 7  8  17 9  0  1  2  3  10 11 12 0  0  1  2  4  17
17 13 11 0  8  17 9  0  6  18 7  1  2  3  0  0  6  18 18 17
17 9  1  2  4  17 5  3  10 11 12 6  18 7  0  0  10 11 14 17
17 9  6  18 18 17 18 7  0  0  0  10 11 12 0  0  0  0  8  17
17 9  10 11 11 11 11 0  1  2  2  3  0  0  0  0  0  0  8  17
17 9  0  0  0  0  0  0  6  18 18 7  0  1  2  2  3  0  8  17
17 9  0  0  0  0  0  0  10 11 11 12 0  6  18 18 7  0  4  17
17 9  0  0  0  0  0  0  1  2  3  0  0  10 11 11 12 6  18 17
17 9  0  0  0  1  2  3  8  18 5  3  0  0  0  0  0  2  14 17
17 9  0  1  2  4  18 7  8  17 18 5  3  0  0  0  6  18 16  17
17 5  2  4  18 18 17 5  4  17 17 18 5  2  2  2  2  15 4  17
17 18 18 18 17 17 17 18 18 17 17 17 18 18 18 18 18 18 18 17