25
15
17 17 7 0 0 0 0 0 0 0 0 0 0 0 0 0 0 0 0 0 6 17 17 17 17
17 13 0 0 0 0 0 0 0 0 0 0 0 0 0 0 0 0 0 0 0 15 15 4 17
17 9 0 0 0 0 0 0 0 0 0 0 0 0 0 0 0 0 0 0 0 18 18 18 17
17 9 18 18 18 18 0 0 0 0 0 0 0 0 0 0 0 2 2 2 2 2 0 8 17
17 9 0 0 0 0 0 0 0 0 0 0 0 0 0 0 0 18 18 18 18 18 0 8 17
17 9 0 0 0 0 0 0 0 0 0 0 2 2 2 2 2 0 0 0 0 0 0 8 17
17 18 18 18 0 0 0 0 0 0 0 0 18 18 18 18 18 0 0 0 0 0 0 8 17
17 9 0 15 0 0 0 0 0 0 0 2 15 15 0 0 0 0 0 0 0 0 0 8 17
17 9 0 18 18 18 18 0 0 0 0 18 18 18 0 0 0 0 0 0 0 0 0 8 17
17 9 0 0 0 0 0 0 0 0 0 0 0 0 2 2 2 2 0 0 0 0 0 8 17
17 9 18 0 0 0 0 0 0 0 0 0 0 0 18 18 18 18 0 0 0 0 0 8 17
17 9 0 18 0 0 0 0 1 2 2 2 2 2 15 15 3 0 0 0 0 0 0 8 17
17 9 0 0 18 0 0 0 0 18 18 18 18 18 18 18 0 0 0 0 0 0 0 8 17
17 18 2 2 2 2 2 2 2 2 2 2 2 2 2 2 2 2 2 2 2 2 2 4 17
17 17 17 17 17 17 17 17 17 17 17 17 17 17 17 17 17 17 17 17 17 17 17 17 17